29
6633 854 25 1151 4628 
0.13
x.......x.
x.....xx.x
.x..xx...x
.x.x.....x
.x..xx...x
.x....x.x.
..x..x...x
...x.x..x.
....x...x.
.........x
29
<5455544421287823232455564654>
