404
21025 2639 11 2295 16091 
0.343
xx........
..x.......
...xx.....
.....x....
......x...
......x...
.......x..
.......x..
........x.
.........x
404
<34434454544>
