606
97681 12301 91 9567 75813 
1.406
x...................
.xx.................
...xx.x.............
.....x.x............
........x..x........
.........xx.x.......
............x.......
.............x......
..............x...x.
...............xxx.x
606
<43434244432454443324>
