335
21281 2671 11 1964 16646 
0.314
x.........
x.........
.x........
..xx......
....x.....
.....x....
....x.....
....x.....
.....x....
......x...
......x...
.......x..
........x.
........x.
.........x
335
<544344654454454>
