58
64361 8082 37 2255 54024 
0.914
xx................
..x...............
..x...............
...x..............
...x.x............
....x.x...........
.......x..........
........x.........
.......x..........
........x.........
........x.........
.........x........
........x.........
.........x........
..........x.......
..........x.......
...........x......
............x.....
.............x.x..
..............x.xx
58
<3454542444645464454444243>
